111111111111111111111111111111
1000000000000000001E1000000001
101111011110111100101001111011
101111C11110111100101001111011
10111101111C111100101001111C11
101111011110111100101001111011
100000000000000000000000000001
100000000000000000000000000001
100000000000000000000000000001
101111011110111100101001111011
10111101111C111100101001111C11
101111C11110111100101001111011
101111011110111100101001111011
1000000000000000001P1000000001
111111111111111111111111111111