0000000000000
000100C0000C0
0C00011111000
0P0011E000000
0000000000000